合眼缘	形状有趣
图案好看	字型好看
因为黑底的图片感觉更清晰	因为跟第一张黑底图片相似
奇奇怪怪	因为它很方，好看
因为感觉像笑脸让人心情愉悦	因为感觉方方正正的
长得很自由	这个长的很方正
看起来很可爱	看起来像个呆呆的小人，超级可爱
工整	好看
像笑脸	唯一像我认识的字
方正	像山
凭感觉	方正
人形	长得很奇怪
简单大方	简约大气
好看	美丽
简单大方	有趣
简单易懂	有趣
简单易懂	好玩
走路的人	在跳的小人
小人	微笑
笑起来很可爱	子曰
很像小山	很像微笑的嘴巴
是个笑脸	是方下巴的笑脸
眼缘	眼缘
有挑战性	简单，便于首次尝试
有意思	有意思
萌萌的笑脸	曰
方形铲子	圆形铲子
可爱笑脸	方方的爪子
小日子	双峰山
两只老虎爱跳舞，b站上一个魔性舞蹈的动作	自信的体态，自由的气息，像极了艾伦耶格尔
它长得像个人	阳光照耀着我们
圆润有意思	有多个组成部分
像一个笑脸 很有趣	很方正简约
很像山	像一个符号，给我力的感觉
比较容易临摹	看着像笑脸
图案类似一个笑脸	由很多奇怪的图案组成
曰字提醒要时刻注意言语	重峦叠嶂
觉得很可爱 笑着流泪，但右眼睫毛掉下来了	乐
形状简单	形状有趣
简单	简洁
像个人	简约
形状简单	像一个人在送另外一个人花
像多峰的山，象形文字的感觉	像曰字
小丑	超威蓝猫
像篝火晚会	像日字
像两个小人	像太阳简笔画
像一个笑脸	形状有趣
字形像花，很美	看起来很像一个笑脸，临摹难度小
创作的刚劲有力	看起来像一个人
元素丰富，像鸡，草，人的组合	像个笑脸
很有创意，像某种神秘字符	简洁
只剩下这张图了，一人的形态相似	比较有趣，给人一种慵懒的感觉
很简约	简约大气
有意思	简约大方
粗犷	秀气简约
正着看像一座山，侧面看又像“习”字	可以有不同的理解，比较有趣
看着像一个笑脸很可爱	看着比较好玩
看起来像笑脸	方正，比较好看
强颜欢笑	笑脸
象形文字很有意思	不忍拆散两兄弟
看起来像个可爱的人类	比较喜欢修长的结构
看起来像一个站立的人准备行走	因为像一座山
像一个很自在的方头人	
像一个人拿着工具在衣架前准备出门。	像碗里面有冒热气的汤
用简单的文字元素构建了一个完整的封闭图形，很好地传递了画面上方的信息	元素众多，三角形，圆形，线条；空间感很强，画面的上下左右都有元素排列
像是一个人在猎场打猎	像一个穿着华丽礼服的人
方方块，像那个真话之口(也许叫这名字)	很快乐的笑脸
人举行狩猎仪式	方正曰字
像一个呆傻的人	像一座山
比较特别	构图巧妙
笑脸好看	看起来很高级
方正中透着圆滑，构图简单精妙，像是在微笑一般，令人愉悦	笔锋圆润又不失骨感，构图巧妙，有独特的韵味
看起来比较随意	方正
没得选了	就剩这两个了
笔画少，很简洁	字体很形象，生动，很容易明白意思
结字简单又容易理解	字体古朴，富有趣味，有象形意味
像笑脸，给人开心的感觉	很像一个舞动的小人。
造型很独特，具有美感	方方正正的，很规整
快乐的笑脸 很符合我今天的心情	比较圆润，看起来很舒服
像正在跳舞的人。	结构相对简单。
“元”的异变	像树枝树叶
看起来很开心	今天有大太阳
一个人托举重物	一个人举着重物前行
看起来像个“曰”字	这个字比较简单
笑脸	好看
简单易懂，有慵懒感	简约大气
像一个慵懒惬意走路的小人	像一个累了弯腰休息的小人 又像一株奇特的植物
像个笑脸，觉得看着很乐	好临摹，图可爱
像个动物的爪子 很特别	很像远古洞穴上的符号
部分很多	这俩长得相似
笑脸很可爱	看着像曰
它是个小人，看上去很孤独	看着很抽象
像笑脸，图像平衡有一定对称美感	图像方正端庄
简洁明了	简洁形象
“曰”字，简洁明了，字样清晰	似笑非笑
笔画很多，看起来很有趣	看起来像一个走路的小人
看起来有趣	方正
工整好临摹	笔画少好临摹
笔画少，好临摹	这个曰字在几个样本中写得比较好
像个小人，看着很可爱	若隐若现的曰
很平和但很简单的一个字，感觉不急不争，是理想的状态	一个很可爱的小人
因为看不出才是什么所以激起我的兴趣	"若隐若现的日
"
笔画看起来具有一种生机	笔画比较简单
看上去摆放的很整齐，我很喜欢	表达我对太阳天的控诉
该字等于字母E加一or目减1	造型像练习了两年半时长
有点像山	和今天的大太阳对应
有种原始透露着野性的美	因为像曰
像一个会心的笑容，可可爱爱	方方正正却留有缺口和余地
像个爪子	像曰
山在笑	出列！
像个人在篝火旁站着	日！
	
口中有舌头	孤单小人
指向12点的表	锁
方正工整	合眼缘
一个人	元
形状合眼缘	像个笑脸
它看上去有点紧张，我要把它抓出来	它看上去有些惊讶，我要把它想表达的突出出来
太阳	连续的山峰
农田	一把梳子
像一个大笑的人	太阳
微笑	比较复杂奇特
有意思	有意思
口中一个一，像闭着的眼睛	像伸出来的舌头
像一个字，比较好写	看起来比较正气
有意思	比较抽象
从照片这个角度看是一个微笑脸，横过来看像字符	像"人"的象形字
我独自起舞，独自美丽	摊摊手，不关我的事
看起来笑的很开心，实际上是SB	在文言文里经常见到这个字
方正，独立，像个笼子	有条理的感觉
比较简洁	像一个人弯腰
方正	很形象
像猪鼻子	一个1
像山	表情微笑
因为很喜欢元这个字，而且这个写法就很有万物之始	很有自然的感觉，也很有童趣，有万物的感觉
笑	曰
日字	元字
曰字	像人形
看起来像笑脸，下面的笔画很潇洒	像一个人，姿势很有趣
像问	呆一布
笑	日子
节奏和秩序	规整的同时多样
曰	笑
熟悉，似字“日”	熟悉，似字“山”，但透露出憨意
子曰	勇敢向上
山外有山	赞美太阳！
人	元
有大国统帅风采（	比较简约大气
日象征光明	子曰
