WA: 合眼缘, 有挑战性, 创作的刚劲有力, 象形文字很有意思, 因为看不出才是什么所以激起我的兴趣, 有意思, 好看, 就剩这两个了, 一个人举着重物前行, 像一个累了弯腰休息的小人 又像一株奇特的植物
HB: 图案好看, 比较容易临摹, 有点像山, 它看上去有点紧张，我要把它抓出来, 眼缘, 看起来很像一个笑脸，临摹难度小, 因为像一座山, 这个字比较简单, 有条理的感觉
WB: 因为黑底的图片感觉更清晰, 有意思, “元”的异变, 像一个符号，给我力的感觉, 不忍拆散两兄弟, 比较喜欢修长的结构, 笔锋圆润又不失骨感，构图巧妙，有独特的韵味, 元, 像一个人弯腰
HC: 奇奇怪怪, 看起来像笑脸, 方正中透着圆滑，构图简单精妙，像是在微笑一般，令人愉悦, 像山, 方方的爪子, 简洁, 笔画少好临摹, 一把梳子, 很形象
SA: 因为感觉像笑脸让人心情愉悦, 看起来很可爱, 像一个笑脸 很有趣, 笔画少，很简洁, 快乐的笑脸 很符合我今天的心情, 看起来很开心, 像个笑脸，觉得看着很乐, 像一个大笑的人, 看起来像笑脸，下面的笔画很潇洒, 有趣, 微笑, 像碗里面有冒热气的汤
SC: 长得很自由, 好看, 萌萌的笑脸, 看起来比较随意, 像个动物的爪子 很特别, 笔画少，好临摹, 像个爪子, 微笑, 从照片这个角度看是一个微笑脸，横过来看像字符, 像猪鼻子, 笑, 乐, 像个笑脸, , 勇敢向上
ZA: 工整, 口中有舌头, 像一个字，比较好写, 方正, 子曰, 简约, 方正，比较好看, 方正, 方方正正的，很规整, 表达我对太阳天的控诉, 日！
SD: 像笑脸, 可爱笑脸, 图案类似一个笑脸, 看着像一个笑脸很可爱, 笑脸好看, 像笑脸，给人开心的感觉, 笑脸, 笑脸很可爱, 看起来有趣, 像一个会心的笑容，可可爱爱, 笑, 很像微笑的嘴巴, 笑脸, 像伸出来的舌头, 笑
YD: 方正, 形状简单, 用简单的文字元素构建了一个完整的封闭图形，很好地传递了画面上方的信息, 指向12点的表, 曰, 简单，便于首次尝试, 简约大气, 看着像曰, 像曰, 在文言文里经常见到这个字
SB: 凭感觉, 笑起来很可爱, 是个笑脸, 像一个笑脸, 像笑脸，图像平衡有一定对称美感, 有种原始透露着野性的美, 看起来笑的很开心，实际上是SB, 圆形铲子, 看着像笑脸, 很快乐的笑脸, 像个笑脸, 表情微笑
FB: 人形, 它长得像个人, 像一个很自在的方头人, 没得选了, 看起来像一个人, 看起来像一个走路的小人, 孤单小人, 摊摊手，不关我的事
ZD: 简单大方, 粗犷, 因为感觉方方正正的, 像日字, 方正曰字, 若隐若现的曰, 太阳, 曰, 日子, 子曰
YA: 简单大方, 结字简单又容易理解, 太阳, 熟悉，似字“日”, 好玩, 很方正简约, 秀气简约, 今天有大太阳, 这个曰字在几个样本中写得比较好, 合眼缘
YB: 简单易懂, 曰字提醒要时刻注意言语, 简洁明了, 很平和但很简单的一个字，感觉不急不争，是理想的状态, 方正，独立，像个笼子, 曰字, 这个长的很方正, 像曰字, 简约大方, 结构相对简单。, 简约大气, 赞美太阳！
ZB: 简单易懂, 形状简单, 很简约, 方方块，像那个真话之口(也许叫这名字), 日字, 日象征光明, 曰, 和今天的大太阳对应, 锁, 比较简约大气
FC: 走路的人, 像个人, 有意思, 看起来像个可爱的人类, 像正在跳舞的人。, 像一个慵懒惬意走路的小人, 有意思, 我独自起舞，独自美丽, 一个很可爱的小人, 像一个人，姿势很有趣
FD: 小人, 只剩下这张图了，一人的形态相似, 看起来像一个站立的人准备行走, 像一个呆傻的人, 它是个小人，看上去很孤独, 一个人, 人, 形状有趣, 看起来像个呆呆的小人，超级可爱, 自信的体态，自由的气息，像极了艾伦耶格尔, 好临摹，图可爱, 出列！, 有意思, 呆一布
HD: 很像小山, 方形铲子, 很像山, 正着看像一座山，侧面看又像“习”字, 强颜欢笑, 山在笑, 方正工整, 像山, 有大国统帅风采（, 方正, 是方下巴的笑脸, 像一座山, 简洁形象, 笔画比较简单, 熟悉，似字“山”，但透露出憨意
HA: 眼缘, 像多峰的山，象形文字的感觉, 很有创意，像某种神秘字符, 该字等于字母E加一or目减1, 节奏和秩序, 山外有山, 美丽, 双峰山, 重峦叠嶂, 似笑非笑, 连续的山峰, 看起来比较正气
ZC: 小日子, 简单, 看起来像个“曰”字, 比较简洁, 唯一像我认识的字, 子曰, 可以有不同的理解，比较有趣, "若隐若现的日, 方方正正却留有缺口和余地, 它看上去有些惊讶，我要把它想表达的突出出来
WC: 两只老虎爱跳舞，b站上一个魔性舞蹈的动作, 造型很独特，具有美感, 一个人托举重物, 简单易懂，有慵懒感, , 形状合眼缘, 因为很喜欢元这个字，而且这个写法就很有万物之始, 有趣, 比较有趣，给人一种慵懒的感觉, 很像一个舞动的小人。, 造型像练习了两年半时长, 比较抽象, 元字, 元
EB: 圆润有意思, 字形像花，很美, 像是一个人在猎场打猎
ED: 觉得很可爱 笑着流泪，但右眼睫毛掉下来了, 元素丰富，像鸡，草，人的组合, 元素众多，三角形，圆形，线条；空间感很强，画面的上下左右都有元素排列, 看着很抽象, 很有自然的感觉，也很有童趣，有万物的感觉
LC: 小丑, 字体古朴，富有趣味，有象形意味, 比较圆润，看起来很舒服, 这俩长得相似
EC: 像篝火晚会, 人举行狩猎仪式, 部分很多, 字型好看
LA: 像两个小人, 比较特别, 看上去摆放的很整齐，我很喜欢
LB: 像一个人拿着工具在衣架前准备出门。, 像一个人在送另外一个人花, 字体很形象，生动，很容易明白意思, 像树枝树叶, 比较复杂奇特
YC: “曰”字，简洁明了，字样清晰, 农田, 口中一个一，像闭着的眼睛, 因为它很方，好看, 简约大气, 阳光照耀着我们, 像太阳简笔画, 简洁, 方正, 因为像曰, 一个1
EA: 笔画很多，看起来很有趣, 笔画看起来具有一种生机, 像个人在篝火旁站着, 像问, 长得很奇怪, 由很多奇怪的图案组成, 好看, 
WD: 工整好临摹, 因为跟第一张黑底图片相似, 有意思, 形状有趣, 看着比较好玩, 构图巧妙, 图像方正端庄
FA: 像个小人，看着很可爱, 在跳的小人, 超威蓝猫, 像一个穿着华丽礼服的人, 像人形
LD: 有多个组成部分, 形状有趣, 看起来很高级, 很像远古洞穴上的符号, 规整的同时多样
": 像"人"的象形字
