SA: 看起来很让人心情愉快, 很可爱, 简单, 像笑脸开心, 很可爱, 可爱, 有趣像笑脸, 像一个笑脸 看见心情会变好, 笑的很嚣张, 像emoji, 可爱
SD: 上面有开心的祝福，开心最重要, 笑脸很好, 像很可爱的笑脸, 样子挺可爱, 字很好看, 让人开心, 笑脸很可爱, 看到了很开心, 比较特别，看起来有趣, 好看, 笑脸可爱, 笑脸很可爱, 可爱笑脸, 很有趣很可爱, 能看出是一个笑脸
SB: 很快乐，且饱满，笔画匀称, 流畅, 可爱的笑脸，看了心情好, 笑脸看了心情好, 简单, 可爱, 是笑脸, ：）, 规整好看, 像燃烧的火焰 很有意思, 有趣, 像个笑脸，治愈
EC: 图案绘制看起来很精致, 显眼, 够抽象, 笔触很吸引人
FA: 很明显，很有趣，看到这一面墙的第一反应, 像个小人, 杂乱, 如同披着蓑衣的武侠小人, 抽象小人
WC: 笔画好看，饱满规整, 圆润, 有设计感, 流畅, 比较规整, 图案有趣, 好看, 圆润，匀称, 整洁美观, 有个性, 很遒劲，有书法的感觉, 自己也画过，喜欢, 好看, 简约, 弱弱的
FD: 呆，很像一个人, 很可爱 很工整, 标致, 像个呆的人, 画的很有味道, 很有趣, 火柴人, 呆呆的, 像人, 有意思, 生动, 很有意思的, 很抽象
LD: 富有哲理的临摹, 有意思, 很奇特, 圆润可爱, 画的好
WA: 整体结构比较好看，笔画工整, 显眼, 较为工整, 独特, 符号有趣, 很有意思的图案, 很方正, 清秀
WD: 工整美观, 笔锋斗转，骨感有序，整个字看上去很精神, 不仅有临摹的图案，还有自己的理解, 美观简洁, 不懂, 符号简洁, 简洁
ZD: 字迹工整, 简洁, 写的板正, 方正, 整齐, 整洁, 写的很规整, 加上注解有一种故事感, 规整, 线条简单
HD: 顺眼, 有趣, 干净, 不对称但平衡, 比较工整, 线条清晰，画的很可爱, 清晰整齐, 不用再照照片了, 少数的用了面, 工整, 画的很生动可爱, 可爱，整洁的小笑脸, 整体和谐, 工整大气, 好, 线条简单
HB: 方正, 简洁, 很规整, 形态可爱, 看不懂，但大为震撼, 方正有趣, 很工整, 随机, 蒂
FC: 很生动, 心血来潮, 生动, 有意境, 呆呆的小人感觉有点孤独, 顺眼, 飘逸, 像是在跳舞, 心血来潮, 很奇怪
ZC: 简约大方, 好看，方正, 帅, 干净整洁, 大气整洁, 笔画简洁干练, 圆润通透，干净利索, 画了笑脸，很调皮, 简约, 有字
EA: 写的跟我写的很像, 对字的解释比较有意思, 简单, 酷似甲骨文, 很喜欢, 图案有趣, 很可爱, 抽象
LC: 挺好看的, 字很活泼, 图案有趣, 画的像个气球，可爱, 舒畅
EB: 字很好看, 形象生动, 很有意思
ZA: 写的很秀气，这个字我也写过, 简单, 简洁, 大气, 字跟我写的一样, 很方正, 很简约, 整洁, 比较简洁, 鸡蛋, 简洁
SC: 有趣, 可爱, 像笑脸，让人开心, 笑脸开心, 还行, 笑的很开心, 看起来很开心, 好看, 简单好, 有趣掌印, 有趣像笑脸, 尖嘴笑脸, 线条好看, 像个笑脸
WB: 简单, 简约, 第一眼看到了, 突出, 很美观, 非常的规矩, 规整, 很有古文的味道, 好看
YD: 板板正正, 很规整, 随机, 写的很好, 方正, 和我写的好像，以为是我的, 十分方正
YA: 解释很独特, 有一种简约的美, 线条比较清晰, 线条细且清晰, 线条简单, 勾边留白的形式比较特别, 古朴典雅
ED: 好看, 舒适, 有趣, 有趣, 有特色
HC: 不错, 可爱，大方，整洁, 很粗犷, 活泼饱满, 线条利落, 线条简单, 凌乱美, 很圆润
ZB: 工整, 规整, 正方, 规整, 好看, 工整, 干净整洁, 简约，清爽, 方正
YB: 整齐, 工整, 比较清晰, 线条简单, 比较圆润, 特别, 这个日写的像一幅画一样, 规整, 线条简单, 整洁
HA: 好看, 工整, 很简练, 简约, 写得好, 不错, 字很多，有想法, 很工整, 很酷, 奇特, 写了注解, 笔画较散
FB: 像一个人, 好看, 呆呆的, 比较好看, 和第一个一样, 不错, 灵动小人, 很有童真
LB: 整体效果整洁清爽, 很复杂很喜欢, 有趣, 好看, 像是两个小孩打架
YC: 规整, 随机, 简洁，位置很好，简单但很用心, 有文字解释，布局美观, 字好看, 毛毛的, 比较合眼缘
LA: 工整, 像一副图画
